> v 0 0 1
> v 1 0 0
0 v 0 1 0
1 v 0 0 0
0 v 0 0 0