> v 0 0 O
< v O 0 0
0 v 0 1 0
1 v 0 0 0
0 v 0 0 0
