> v 0 0 I 0
< v W 0 0 0
O v 0 C 0 0
0 0 0 0 0 0
0 0 0 0 0 0
Oil
