- - - - - - W - - - - - - I - - C
- C - - - - - - - - - C - - - - -
- - - I - - - I - - - - - - - - -
- - - - - - - - - - - - W - - - -
I - - - - W - - W - - - - - - - -
- - - - - - - - - - - - I - - - I
- - - I - - O - - C - - - - - - -
- W - - - - - - - - - - - - - - -
- - - - - W - - - - - - - - - - E
Automobiles